level1map= """
#######################################################
#######################################################
#######...#
######....#
####.....##
####.....#
####.....#
###......#
###......#
###......#
###......#
###......#
###......#
###......#
###...........
#############.
#..........##
#.########.
#.########.
#.########.
###
###
###
###
###
###
###
###
###
###
###
###
###
###
###
###
###
###
###
###
###
###
###
###
###
###
"""
